..................................................................
..................................................................
...............G.......................................GG.........
..................................................................
..................................................................
..............GGG.............................GGG.................
..................................................................
..................................................................
..................................................................
.......................G..........................................
......................GG..........................................
........GGG..........GGG..........................................
....................GGGG............................GGGG..........
..................................................................
.......................................GGGG.......................
..................................................................
..................................................................
GGGGGGGGGGGGGGGGGGGGGGGGGGGGGGGGGGGGGGGGGGGGGGGGGGGGGGGGGGGGGGGGGG